101010101010110101100010101001
000000000000000000000000000000
000000000000000000000000000010
101010100000100000011111000000
101010100000100001011110000000
101010100000011100000000000000
000000000000000000000000000000
000000000000000000000000000000
000111101000001000000000000000
000100001100011000000000000000
000100001010101000000000000000
000111101001001000000000000000
000000000000000000000000000000
000000000000000000000000000000
000000000000000000000000000000
101010100000011100000000000000
000000000000000000000000000000
000000000000000000000000000010
101010100000100000011111000000
101010100000100001011110000000
101010100000011100000000000000
000000000000000000000000000000
000000000000000000000000000010
101010100000100000011111000000
101010100000100001011110000000
101010100000011100000000000000
000000000000000000000000000000
000000000000000000000000000010
101010100000100000011111000000
101010100000100001011110000000